000000000000000000000000000333
000000000000011111111100000333
000111110000000001000000000333
000000010011110001000000001000
000000010010010001000000010000
000000010000010011100000100000
000000011111110000100001000000
000000000000010000111010000000
000000000000010001000100000000
000000001110010010001000000000
003330000010010100010000000000
003330000011111000100000000000
003330000000000001000000000000
000002200000000010000000000000
000002200000000100000000000000
000000010000001000000000000000
000000000000010000000000000000
000000000000100000000000000000
000000000001000000000000000000
000000000010000000000000000000
000000000100000000000000000000
000000001033300000000000000000
000000010033300000033300000000
000000100033300000033300000000
000001000000220000033300000000
000010000000220000000000000000
000100000000100220000000000000
000000000000010220000000000000
000000000000001000000000000000
000000000000000000000000000000
000000000000000000000000000000