000000000000000000000000000000
011111111111111111111111111110
000000000000000000000000000010
001111111111111111111111111010
001000000000000000000000001010
001011111111111111111111101010
001010000000000000000000101010
001010111111111111111110101010
001010100000000000000010101010
001010101111111111111010101010
001010101000000000001010101010
001010101011111111101010101010
001010101010000000101010101010
001010101010111110101010101010
001010101010100010101010101010
001010101010101010101010101010
001010101010101010101010101010
001010101010101110101010101010
001010101010100000101010101010
001010101010111111101010101010
001010101010000000001010101010
001010101011111111111010101010
001010101000000000000010101010
001010101111111111111110101010
001010100000000000000000101010
001010111111111111111111101010
001010000000000000000000001010
001011111111111111111111111010
001000000000000000000000000010
001111111111111111111111111110
000000000000000000000000000000